F 0,0,0
C 0,200,255

NO ./sprites/colorstone.xpm
SO ./sprites/greystone.xpm
WE ./sprites/redbrick.xpm
EA ./sprites/wood.xpm



        1111111111111111111111111
        1000000000110000010100001
        1001000001110000010100001
        1001000000000000000000001
111111111001000001110000000000001
100000000001000001110000111111111
11110111111111011100000000001
11110111111111011100000000001
11000000110101011100000000001
10000000000000000000000000111
10000000000000001101001000011
11000001110000011111001N000111
11110111 1100001 101111000001
11111111 1111111 111111111111
