F 0,255,0
C 0,200,255

NO ./sprites/exit.xpm
SO ./sprites/ground.xpm
WE ./sprites/playerE_1.xpm
EA ./sprites/wall.xpm



        1111111111111111111111111
        1000000000110000010100001
        1001000001110000010100001
        1001000000000000000000001
111111111001000001110000000000001
100000000001000001110000111111111
11110111111111011100000000001
11110111111111011100000000001
11000000110101011100000000001
10000000000000000000000000111
10000000000000001101000000011
1100000111000001111100000000111
11110111 1100001 10111100N001
11111111 1111111 111111111111
