F 220,100,40
C 225,30,10

NO ./sprites/coin.xpm
SO ./sprites/crate.xpm
WE ./sprites/exit.xpm
EA ./sprites/ground.xpm



111111111111111111111111111111111
100000000000000000000000000000001
100000000000000000000000000000001
100000000000000000000000000000001
100000000000000000000000000000001
100000000000000000000000000000001
100000000000000000000000000000001
100000000000000000000000000000001
100000000000000000000000000000001
100000000000000000000000000000001
100000000000000000000000000000001
100000000000000000000000000000001
1000000000000000000000000000000N1
111111111111111111111111111111111
