F 0,255,0
C 0,200,255

NO ./sprites/coin.xpm
SO ./sprites/crate.xpm
WE ./sprites/exit.xpm
EA ./sprites/ground.xpm



        1111111111111111111111111
        1000000000110000010100001
        1011000001110000010100001
        1001000000000000000000001
111111111011000001110000000000001
100000000011000001110111111111111
11110111111111011100000000001
11110111111111011101010000001
11000000110101011100000000001
10000000000000001100000000111
10000000000000001101010000011
1100000111010101111101110000111
11110111 1110101 10111101N001
11111111 1111111 111111111111
