F 220,100,40
C 225,30,10

NO ./sprites/coin.xpm
SO ./sprites/crate.xpm
WE ./sprites/exit.xpm
EA ./sprites/ground.xpm



	11111111111 1111111111111
	10000000001 1000000000001
	1011000001111000000000001
	1001000000000000000000001
111111111011000001110000000000001
100000000011000001110111111111111
11110111111111011100000010001
11110111111111011101010010001
11000000110101011100000010001
10000000000000001100000010001
10000000000000001101010010001
11000001110101011111011110N0111
11110111 1110101 101111010001
11111111 1110111 111111111111
